%%%%%%%%%%%%%%%%%%%%%%
%          %...   .%.%
%            %%%%%%%.%
%            %     % %
%          %%%%%    .%
%           .%. .% %%%
%           %%%%%% %.%
%           %....%   % 
%           %.%%%%   %
%                    %
%                    %
%                    %
%                    %
%              %%%   %
%13          %...% 24%
%%%%%%%%%%%%%%%%%%%%%%