%%%%%%%%%%%%%%%%%%%%%%
%13            %  .%.%
%          %.% % %%%.%
%          % %     %.%
%          %%%%%    .%
%            %..   %%%
%            %%%   %.%
%                    % 
%                    %
%                    %
%                    %
%                    %
%                    %
%                    %
%                    %
%                    %
%                  42%
%%%%%%%%%%%%%%%%%%%%%%