%%%%%%%%%%%%%%%%%%%%%%
%13        %       % %
%            %%%%%%% %
%            %     % %
%          2%%%%     %
%             %  % %%%
%          4%%%%%% % %
%           %    %   % 
%             %%%%   %
%                    %
%                    %
%                    %
%                    %
%              %%%   %
%            %  o%   %
%%%%%%%%%%%%%%%%%%%%%%